22222222222222222222
22222222222222111122
22222222222211101122
22222211111111001122
22211110000000001222
21111110000000111222
22111000000000011222
22211000000000001122
22221000000000001112
22221111000000011122
22222211000000112222
22222221100011122222
22222222111222222222
22222222222222222222
22211112222222222222
22110011122222222222
21100001112222222222
22111011122222222222
22211111222222222222
22222222222222222222
